#####################
#...#               #
#.# #               #
#                   #
#                   #
#                   #
#                   #
#                   #
#                   #
#                   #
#                   #
#                   #
#                   #
#                   #
#                   #
#####################